NO texture/north.xpm
SO texture/south.xpm
WE texture/west.xpm
EA texture/east.xpm
F 220,100,0
C 225,30,0

1111111111111111
1000000000000001
1000000000000001
1000000000000001
100000E110000001
1000000001000001
1000000000000001
1000000000000001
1000000000000001
1111111111111111
