NO ./textures/north.xpm
SO ./textures/south.xpm
WE ./textures/west.xpm
EA ./textures/east.xpm

F 220,100,0
C 225,30,0

111111111111
100000000001
100000000001
100001000001
1000N1110001
100000110001
100000010001
100000000001
111111111111
