NO texture/north.xpm
SO texture/south.xpm
EA texture/east.xpm
WE texture/west.xpm

C 251,30,0
F 0220,100,0

1111111111111111
1000000000000001
1000000000000001
10000000000000N1
1111111111111111
