NO texture/north.xpm
SO texture/south.xpm
EA texture/east.xpm
WE texture/west.xpm


F 164,169,20
C 153,204,255

        1111111111111111111111111
        1000000000110000000000001
        1011000001110000011000001
        1001000000000000011000001
111111111011000001110000000000001
100000000011000001110011111111111
11110111111111011100000010001
11110111111111011101010000001
11000000110101011100000010001
10000000000000001100000010001
10000000000000001101010010001
11000001110101011111011110N0111
11110111 1110101 101111010001
11111111 1111111 11111111111
